10 00 05 01 11 01 27 20 29 01 01 00 01 01 01
01 00 00 00 00 00 00 00 00 01 01 00 01 16 00
09 00 06 00 28 01 00 01 08 07 01 00 01 01 00
01 00 01 00 01 01 00 01 00 00 01 00 01 17 00
19 00 01 00 03 04 00 01 00 01 01 00 01 01 00
00 00 00 31 00 00 00 00 00 00 00 00 00 00 00
18 00 01 30 01 23 24 01 01 01 12 13 01 01 01
01 00 01 32 33 25 26 22 21 01 14 15 01 01 01
01 00 01 34 35 01 01 01 01 01 01 01 01 01 01